########S#
## #     #
#    #####
# # #    #
# #   ## #
########E#